10 10
. . . . . # # . # .
# # # . . . # . . .
. . # # . # . # # .
. # # . . # . # . .
. . # # # # . . . #
# . # . # . . # . .
. . # . . . # # # .
. # # # . # . . . .
. . . . . # . . # #
# # # # # # # . . .