30 15
# . . . . . . . . . . . . . . . . . . . . # # . . . . . . .  
# . # . # # # . . . . . . . . . . . . . . # # . . . . . . . 
# . # . . . # . . . . . . . . . . . . . . # # . . . . . . . 
# . # # # . # . . . . . . . . . . . . . . # # . . . . . . . 
# . # # # . # . . . . . . # # . . . . . . # # . . . . . . . 
# . # # # . # . . . . . . # # . . . . . . # # # # # . . . . 
# . # # # . # . . . . . . # # . . . . . . # # # # # . . . . 
# . # # # . # . . . . . . # # . . . . . . . . . . . . . . . 
# . # # # . # . . . . . . # # . . . . . . . . . . . . . . . 
# . # # # . # . . . . . . # # . . . . . . . . . . . . . . . 
# . # # # . # . . . . . . # # . . . . . . . . . . . . . . . 
# . # # # . # . . . . . . # # . . . . . . . . . . . . . . . 
# . # . . . # . . . . . . # # . . . . . . . . . . . . . . . 
# . . . # # # . . . . . . # # . . . . . . . . . . . . . . .
# # # # # . . . . . . . . # # . . . . . . . . . . . . . . .